aardig - vriendelijk
accepteren - aanvaarden
apparaat - toestel
auto - wagen
bang - bevreesd
beantwoorden - respondereren
bedenken - verzinnen
begeren - verlangen
beginnen - starten
belangrijk - cruciaal
beledigen - krenken
beneden - onder
beoordelen - evalueren
beroemd - vermaard
beslissen - kiezen
betalen - vergoeden
bezoeken - opzoeken
bewegen - in beweging brengen
bezorgen - leveren
blijven - verblijven
boos - kwaad
breken - kapotmaken
dankbaar - erkentelijk
duur - kostbaar
eenvoudig - simpel
eng - griezelig
fantastisch - geweldig
feest - partij
fijn - prettig
geld - poen
geloven - vertrouwen
geven - schenken
gevaarlijk - riskant
geven - aanbieden
gewond - geblesseerd
grap - mop
hard - stevig
helpen - assisteren
herinneren - memoreren
hoeveel - hoeveelheid
huis - woning
intelligent - slim
interessant - boeiend
jong - jeugdig
kijken - gluren
klacht - bezwaar
klaar - gereed
kopen - aanschaffen
kort - bondig
koud - ijzig
kunnen - in staat zijn
laat - tard
leeg - onbezet
leiden - besturen
leuk - amusant
licht - helder
lijden - ondergaan
luisteren - horen
maken - creÃ«ren
mensen - personen
moe - vermoeid
mooi - fraai
nadeel - minpunt
nieuw - recent
normaal - gebruikelijk
oefenen - trainen
ogenblik - moment
omgeving - milieu
onderzoeken - analyseren
ontmoeten - tegenkomen
ontvangen - krijgen
oog - pupil
oplossen - oplossen (probleem)
opruimen - ordenen
oud - antiek
overwegen - afwegen
paar - enkele
poging - attempt
praten - converseren
probleem - kwestie
ruimte - plaats
samen - gezamenlijk
schoon - proper
simpel - elementair
slecht - negatief
slim - sluw
spannend - opwindend
sterk - krachtig
stop - halt
suf - slaperig
tevreden - voldaan
trots - fier
uitnodigen - inviteren
veranderen - wijzigen
verbergen - verstoppen
verdrietig - treurig
verkeerd - fout
verschillend - divers
vertellen - verhalen
verzamelen - collecteren
vlug - snel
voelen - aanvoelen
vragen - verzoeken
vreemd - raar
waar - echt
warm - heet
weg - vertrokken
weten - kennen
wijsheid - kennis
winnen - zegevieren
winter - kou
woning - huis
zeker - vast
ziel - geest
zin - betekenis
zonder - exclusief
zorgen - tobben
